4,2,0,3,1
1,4,3,0,2
0,2,3,1,4
3,0,4,2,1
2,1,0,4,3
